1111111111111111111111111111111111111111111111111111111111111
111111110000000000000000000000000000C111111111111111111111111
1111000100000000000000000000000000000000000000000000000000011
1111000000000000000000000000110000000000000000000000000000001
10000000C0000000000000000000011111111000000000000000111111111
10000011110000000000000000000000000111110000000000000000000E1
1C000011111000000000000000000000000P1111000000000000000000001
1111111111111111111111111111111111111111111111111111111111111