1111011
1000001
1P00000
1E000C1
1111111