11111111111
111001C1011
1P0001110E1
10000000001
11111111111