11111111
10000001
1P000001
1P000001
11111111