111111111111111
1E00110000110C1
100000000000001
10001110000L001
1P0010C00000011
100111000000111
111111111111111
