111111111111111
1E0011000011XC1
100000000000001
100011100000001
1P001XC00000011
1X0111X00000111
111111111111111