111111111111111
1E0011000011XC1
100000000000001
1XX011100000001
1PX01XC00000011
1XX111X00000111
111111111111111
